##########
#A#      #
# # #### #
# #    # #
# #### # #
#      # #
# ###### #
#        #
#######B##
##########
