##########
#B#      #
# # #### #
# # #  # #
# # ## # #
# #    # #
# ###### #
#        #
########A#