#############################
A #   #     #       #       #
# # # # ### # ##### # ##### #
# # # # #   #     # #     # #
# # # # # ######### ##### # #
# # # # #           #     # #
# # # # ########### # ##### #
# # # #           # #       #
# # # ########### # #########
# # #           # #         #
# # ########### # ######### #
# #           # #           #
# ########### # ########### #
#           # #             #
########### # ############# #
#           #               B
#############################